Ы _ _ _ _ _ _ О _
О _ _ Ы _ _ М Ф И
Ф _ И О М _ Ц _ Х
И _ Л _ О М Ф _ К
М И О _ Э _ Я _ Ф
Х Д К _ Ф Ц _ _ А
Ц Х Ф _ Я З Г _ _
К _ _ Л И _ Х А Д
А _ Д К Х _ _ _ _
Д _ С _ К Х А _ _
С _ _ Ш _ _ Д _ _
Ш _ _ Р Е _ _ С _
Р _ _ _ _ _ Е Ш _
Е _ Р _ Б _ Л _ Ш
Б _ _ _ _ _ _ Л Е
Л _ Е Б _ _ И К _
Г _ Ц Я З _ _ _ _
Я _ М Э _ _ З Г Ц
З Ц Я _ У _ _ _ Г
У _ _ Щ _ _ _ _ З
Щ _ Ж Т _ _ _ У _
Т _ _ _ _ _ _ Щ Ж
Ж _ В _ Т _ Щ _ Э
В _ _ _ _ _ Ж Э _
Э _ _ В Ж _ _ Я М
